3 3
7 7 7
7 7
1 1 1 1 1 1 1
1 S 1 0 1 0 1
1 0 1 0 1 0 1
1 0 0 0 0 0 1
1 0 1 0 1 0 1
1 0 1 0 1 E 1
1 1 1 1 1 1 1
7 7
1 1 1 1 1 1 1
1 S 1 0 1 0 1
1 0 1 0 1 0 1
1 0 0 0 0 0 1
1 0 1 0 1 0 1
1 0 1 0 1 E 1
1 1 1 1 1 1 1
7 7
1 1 1 1 1 1 1
1 S 1 0 1 0 1
1 0 1 0 1 0 1
1 0 0 0 0 0 1
1 0 1 0 1 0 1
1 0 1 0 1 E 1
1 1 1 1 1 1 1
