4 6
11 11 11 11 
11 11
1 1 1 1 1 1 1 1 1 1 1 
1 0 0 0 0 0 1 0 0 S 1 
1 1 1 0 1 1 1 0 1 0 1 
1 0 0 0 1 0 0 0 1 0 1 
1 0 1 1 1 0 1 0 1 1 1 
1 0 1 0 0 0 1 0 0 0 1 
1 0 1 0 1 1 1 0 1 1 1 
1 E 0 0 1 0 0 0 0 0 1 
1 0 1 1 1 0 1 0 1 1 1 
1 0 0 0 1 0 1 0 0 0 1 
1 1 1 1 1 1 1 1 1 1 1 
11 11
1 1 1 1 1 1 1 1 1 1 1 
1 0 0 0 1 0 1 0 0 0 1 
1 0 1 1 1 0 1 0 1 1 1 
1 0 0 0 0 0 1 0 0 0 1 
1 1 1 0 1 0 1 1 1 0 1 
1 0 0 0 1 0 0 0 0 S 1 
1 1 1 1 1 0 1 1 1 1 1 
1 E 0 0 1 0 0 0 0 0 1 
1 1 1 0 1 0 1 1 1 0 1 
1 0 0 0 0 0 1 0 0 0 1 
1 1 1 1 1 1 1 1 1 1 1 
11 11
1 1 1 1 1 1 1 1 1 1 1 
1 0 0 0 1 0 0 0 0 S 1 
1 0 1 0 1 0 1 0 1 1 1 
1 E 1 0 1 0 1 0 0 0 1 
1 0 1 1 1 1 1 0 1 1 1 
1 0 0 0 1 0 1 0 0 0 1 
1 0 1 1 1 0 1 1 1 0 1 
1 0 0 0 0 0 0 0 0 0 1 
1 0 1 1 1 1 1 1 1 0 1 
1 0 0 0 0 0 1 0 0 0 1 
1 1 1 1 1 1 1 1 1 1 1 
11 11
1 1 1 1 1 1 1 1 1 1 1 
1 0 0 0 0 0 0 0 0 0 1 
1 0 1 1 1 1 1 0 1 0 1 
1 0 0 0 1 0 0 0 1 0 1 
1 0 1 1 1 0 1 1 1 0 1 
1 S 1 0 0 0 1 0 0 0 1 
1 1 1 0 1 1 1 1 1 1 1 
1 0 0 0 1 0 0 E 0 0 1 
1 1 1 0 1 1 1 0 1 1 1 
1 0 0 0 0 0 0 0 0 0 1 
1 1 1 1 1 1 1 1 1 1 1 
11 11
1 1 1 1 1 1 1 1 1 1 1 
1 S 1 0 0 0 0 0 0 0 1 
1 0 1 0 1 0 1 1 1 0 1 
1 0 0 0 1 0 0 E 1 0 1 
1 0 1 1 1 1 1 1 1 1 1 
1 0 0 0 1 0 1 0 0 0 1 
1 0 1 1 1 0 1 1 1 0 1 
1 0 0 0 0 0 0 0 1 0 1 
1 1 1 1 1 0 1 0 1 0 1 
1 0 0 0 0 0 1 0 0 0 1 
1 1 1 1 1 1 1 1 1 1 1 
11 11
1 1 1 1 1 1 1 1 1 1 1 
1 0 0 0 1 S 1 0 1 0 1 
1 1 1 0 1 0 1 0 1 0 1 
1 0 0 0 0 0 1 E 0 0 1 
1 0 1 1 1 1 1 1 1 0 1 
1 0 1 0 0 0 1 0 0 0 1 
1 0 1 0 1 0 1 0 1 1 1 
1 0 1 0 1 0 0 0 0 0 1 
1 0 1 0 1 0 1 1 1 0 1 
1 0 0 0 1 0 1 0 0 0 1 
1 1 1 1 1 1 1 1 1 1 1 
135
9 1 5 1 
8 1 5 1 
7 1 5 1 
7 1 5 2 
7 1 5 3 
8 1 5 3 
9 1 5 3 
9 1 4 3 
9 1 3 3 
8 1 3 3 
7 1 3 3 
7 1 2 3 
7 1 1 3 
7 1 1 4 
7 1 1 5 
8 1 1 5 
9 1 1 5 
9 1 1 6 
9 1 1 7 
8 1 1 7 
7 1 1 7 
7 2 1 7 
7 3 1 7 
7 4 1 7 
7 5 1 7 
7 6 1 7 
7 7 1 7 
8 7 1 7 
9 7 1 7 
9 7 1 8 
9 7 1 9 
8 7 1 9 
7 7 1 9 
7 7 2 9 
7 7 3 9 
8 7 3 9 
9 7 3 9 
9 7 3 8 
9 7 3 7 
8 7 3 7 
7 7 3 7 
7 6 3 7 
7 5 3 7 
8 5 3 7 
9 5 3 7 
9 5 3 6 
9 5 3 5 
9 5 4 5 
9 5 5 5 
9 5 5 6 
9 5 5 7 
8 5 5 7 
7 5 5 7 
7 4 5 7 
7 3 5 7 
6 3 5 7 
5 3 5 7 
5 3 6 7 
5 3 7 7 
5 3 8 7 
5 3 9 7 
5 4 9 7 
5 5 9 7 
4 5 9 7 
3 5 9 7 
3 6 9 7 
3 7 9 7 
2 7 9 7 
1 7 9 7 
1 6 9 7 
1 5 9 7 
1 4 9 7 
1 3 9 7 
2 3 9 7 
3 3 9 7 
3 3 8 7 
3 3 7 7 
3 2 7 7 
3 1 7 7 
2 1 7 7 
1 1 7 7 
1 1 7 6 
1 1 7 5 
2 1 7 5 
3 1 7 5 
3 2 7 5 
3 3 7 5 
3 3 8 5 
3 3 9 5 
3 2 9 5 
3 1 9 5 
2 1 9 5 
1 1 9 5 
1 1 9 4 
1 1 9 3 
1 1 9 2 
1 1 9 1 
2 1 9 1 
3 1 9 1 
3 1 9 2 
3 1 9 3 
3 2 9 3 
3 3 9 3 
3 3 9 2 
3 3 9 1 
2 3 9 1 
1 3 9 1 
1 4 9 1 
1 5 9 1 
1 6 9 1 
1 7 9 1 
2 7 9 1 
3 7 9 1 
3 6 9 1 
3 5 9 1 
3 5 9 2 
3 5 9 3 
3 6 9 3 
3 7 9 3 
3 7 8 3 
3 7 7 3 
3 6 7 3 
3 5 7 3 
3 5 7 2 
3 5 7 1 
3 6 7 1 
3 7 7 1 
2 7 7 1 
1 7 7 1 
1 6 7 1 
1 5 7 1 
1 5 7 2 
1 5 7 3 
1 6 7 3 
1 7 7 3 
