4 6
11 11 11 11 
11 11
1 1 1 1 1 1 1 1 1 1 1 
1 0 0 0 0 0 1 0 0 0 1 
1 0 1 0 1 1 1 0 1 0 1 
1 0 1 S 1 0 0 0 1 0 1 
1 0 1 1 1 0 1 1 1 0 1 
1 0 0 0 1 0 0 0 1 0 1 
1 1 1 0 1 1 1 1 1 0 1 
1 0 0 0 1 0 0 0 1 E 1 
1 1 1 0 1 1 1 0 1 0 1 
1 0 0 0 0 0 0 0 0 0 1 
1 1 1 1 1 1 1 1 1 1 1 
11 11
1 1 1 1 1 1 1 1 1 1 1 
1 0 0 0 1 0 0 0 1 0 1 
1 1 1 0 1 0 1 1 1 0 1 
1 0 1 0 0 0 0 0 0 E 1 
1 0 1 0 1 1 1 1 1 0 1 
1 0 0 0 0 0 0 0 1 0 1 
1 0 1 1 1 1 1 1 1 0 1 
1 0 1 0 1 0 0 0 0 0 1 
1 0 1 0 1 1 1 1 1 1 1 
1 0 0 S 0 0 0 0 0 0 1 
1 1 1 1 1 1 1 1 1 1 1 
11 11
1 1 1 1 1 1 1 1 1 1 1 
1 0 0 S 0 0 0 0 0 0 1 
1 1 1 0 1 1 1 0 1 1 1 
1 0 1 0 1 0 0 0 0 E 1 
1 0 1 0 1 1 1 1 1 0 1 
1 0 1 0 1 0 0 0 1 0 1 
1 0 1 0 1 0 1 1 1 0 1 
1 0 1 0 1 0 1 0 0 0 1 
1 0 1 0 1 0 1 0 1 0 1 
1 0 0 0 1 0 0 0 1 0 1 
1 1 1 1 1 1 1 1 1 1 1 
11 11
1 1 1 1 1 1 1 1 1 1 1 
1 0 0 0 1 0 0 0 1 0 1 
1 0 1 0 1 0 1 1 1 0 1 
1 0 1 0 1 0 0 E 0 0 1 
1 0 1 0 1 0 1 0 1 1 1 
1 0 1 0 0 0 1 0 0 0 1 
1 0 1 1 1 1 1 0 1 1 1 
1 0 0 0 0 0 1 0 1 0 1 
1 1 1 1 1 1 1 0 1 0 1 
1 0 0 S 0 0 0 0 0 0 1 
1 1 1 1 1 1 1 1 1 1 1 
11 11
1 1 1 1 1 1 1 1 1 1 1 
1 0 0 S 0 0 0 0 0 0 1 
1 1 1 1 1 1 1 1 1 0 1 
1 0 0 0 1 0 0 E 1 0 1 
1 1 1 0 1 1 1 0 1 0 1 
1 0 0 0 1 0 1 0 0 0 1 
1 0 1 1 1 0 1 0 1 0 1 
1 0 1 0 0 0 1 0 1 0 1 
1 0 1 0 1 1 1 0 1 0 1 
1 0 0 0 0 0 0 0 1 0 1 
1 1 1 1 1 1 1 1 1 1 1 
11 11
1 1 1 1 1 1 1 1 1 1 1 
1 0 0 0 0 0 0 0 0 S 1 
1 0 1 1 1 0 1 0 1 1 1 
1 0 0 E 1 0 1 0 0 0 1 
1 0 1 0 1 0 1 1 1 0 1 
1 0 1 0 1 0 1 0 1 0 1 
1 0 1 1 1 1 1 0 1 0 1 
1 0 0 0 0 0 0 0 1 0 1 
1 0 1 1 1 1 1 0 1 0 1 
1 0 0 0 0 0 1 0 1 0 1 
1 1 1 1 1 1 1 1 1 1 1 
47
3 3 9 1 
3 2 9 1 
3 1 9 1 
2 1 9 1 
1 1 9 1 
1 2 9 1 
1 3 9 1 
1 4 9 1 
1 5 9 1 
2 5 9 1 
3 5 9 1 
3 6 9 1 
3 7 9 1 
2 7 9 1 
1 7 9 1 
1 7 8 1 
1 7 7 1 
1 7 6 1 
1 7 5 1 
2 7 5 1 
3 7 5 1 
3 7 4 1 
3 7 3 1 
3 8 3 1 
3 9 3 1 
4 9 3 1 
5 9 3 1 
5 9 2 1 
5 9 1 1 
6 9 1 1 
7 9 1 1 
7 9 1 2 
7 9 1 3 
6 9 1 3 
5 9 1 3 
5 9 2 3 
5 9 3 3 
6 9 3 3 
7 9 3 3 
8 9 3 3 
9 9 3 3 
9 9 3 4 
9 9 3 5 
9 8 3 5 
9 7 3 5 
9 7 3 4 
9 7 3 3 
