3 3
11 11 11 
11 11
1 1 1 1 1 1 1 1 1 1 1 
1 0 0 0 0 E 0 0 0 0 1 
1 0 1 1 1 1 1 0 1 1 1 
1 0 1 0 0 0 0 0 1 0 1 
1 1 1 1 1 1 1 0 1 0 1 
1 0 1 0 0 0 1 0 0 0 1 
1 0 1 1 1 0 1 1 1 0 1 
1 0 1 0 1 0 1 S 0 0 1 
1 0 1 0 1 0 1 0 1 1 1 
1 0 0 0 0 0 0 0 0 0 1 
1 1 1 1 1 1 1 1 1 1 1 
11 11
1 1 1 1 1 1 1 1 1 1 1 
1 0 0 0 0 E 1 0 0 0 1 
1 0 1 1 1 1 1 0 1 0 1 
1 0 1 0 0 0 0 0 1 0 1 
1 0 1 0 1 0 1 1 1 1 1 
1 0 1 0 1 0 1 0 0 0 1 
1 0 1 1 1 0 1 1 1 0 1 
1 0 0 0 1 0 0 S 1 0 1 
1 0 1 0 1 1 1 0 1 0 1 
1 0 1 0 0 0 0 0 0 0 1 
1 1 1 1 1 1 1 1 1 1 1 
11 11
1 1 1 1 1 1 1 1 1 1 1 
1 E 0 0 0 0 0 0 1 0 1 
1 0 1 0 1 1 1 0 1 0 1 
1 0 1 0 1 0 0 0 0 0 1 
1 1 1 0 1 0 1 1 1 1 1 
1 0 1 0 1 0 1 0 0 0 1 
1 0 1 0 1 0 1 0 1 0 1 
1 0 0 0 1 0 0 S 1 0 1 
1 0 1 1 1 1 1 0 1 0 1 
1 0 1 0 0 0 0 0 1 0 1 
1 1 1 1 1 1 1 1 1 1 1 
91
7 7 7 
7 7 8 
7 7 9 
8 7 9 
9 7 9 
9 7 8 
9 7 7 
9 7 6 
9 7 5 
8 7 5 
7 7 5 
7 8 5 
7 9 5 
8 9 5 
9 9 5 
9 9 6 
9 9 7 
9 9 8 
9 9 9 
8 9 9 
7 9 9 
7 9 8 
7 9 7 
6 9 7 
5 9 7 
5 9 6 
5 9 5 
5 8 5 
5 7 5 
5 7 6 
5 7 7 
5 6 7 
5 5 7 
5 5 6 
5 5 5 
5 5 4 
5 5 3 
5 6 3 
5 7 3 
5 8 3 
5 9 3 
6 9 3 
7 9 3 
7 8 3 
7 7 3 
7 7 2 
7 7 1 
8 7 1 
9 7 1 
9 6 1 
9 5 1 
8 5 1 
7 5 1 
7 4 1 
7 3 1 
7 3 2 
7 3 3 
6 3 3 
5 3 3 
5 3 4 
5 3 5 
5 3 6 
5 3 7 
6 3 7 
7 3 7 
7 2 7 
7 1 7 
7 1 8 
7 1 9 
6 1 9 
5 1 9 
4 1 9 
3 1 9 
3 1 8 
3 1 7 
2 1 7 
1 1 7 
1 2 7 
1 3 7 
1 3 6 
1 3 5 
1 3 4 
1 3 3 
1 3 2 
1 3 1 
1 2 1 
1 1 1 
2 1 1 
3 1 1 
4 1 1 
5 1 1 
