3 3
21 21 21 
21 21
1 1 1 1 1 1 1 1 1 1 1 1 1 1 1 1 1 1 1 1 1 
1 0 0 0 0 0 1 0 0 0 0 0 0 0 1 0 0 0 0 0 1 
1 0 1 1 1 0 1 0 1 0 1 1 1 1 1 0 1 1 1 0 1 
1 0 0 0 1 0 0 0 1 0 0 0 0 0 0 0 0 0 1 0 1 
1 0 1 1 1 1 1 1 1 1 1 1 1 1 1 1 1 0 1 0 1 
1 0 0 0 0 0 0 0 0 0 0 0 0 0 0 0 1 0 1 0 1 
1 1 1 0 1 1 1 1 1 1 1 1 1 1 1 1 1 1 1 0 1 
1 0 1 0 1 0 0 0 0 0 1 0 0 0 0 0 0 0 1 0 1 
1 0 1 0 1 0 1 1 1 0 1 0 1 1 1 1 1 0 1 0 1 
1 0 0 0 1 0 0 0 1 S 0 0 0 0 0 0 1 0 1 0 1 
1 0 1 1 1 1 1 1 1 1 1 1 1 1 1 1 1 0 1 0 1 
1 0 1 0 0 0 0 0 1 0 0 0 0 0 1 0 1 0 1 0 1 
1 0 1 1 1 0 1 0 1 0 1 1 1 0 1 0 1 0 1 0 1 
1 0 0 0 0 0 1 0 0 0 1 0 0 0 0 0 1 0 1 0 1 
1 0 1 1 1 1 1 1 1 1 1 1 1 1 1 1 1 0 1 0 1 
1 0 1 0 0 0 0 0 1 0 0 0 0 0 0 0 0 0 1 0 1 
1 0 1 0 1 1 1 0 1 1 1 1 1 0 1 1 1 1 1 0 1 
1 0 0 0 1 0 0 0 0 0 0 0 0 0 1 0 0 E 0 0 1 
1 1 1 1 1 1 1 1 1 1 1 1 1 1 1 0 1 1 1 0 1 
1 0 0 0 0 0 0 0 0 0 0 0 0 0 0 0 1 0 0 0 1 
1 1 1 1 1 1 1 1 1 1 1 1 1 1 1 1 1 1 1 1 1 
21 21
1 1 1 1 1 1 1 1 1 1 1 1 1 1 1 1 1 1 1 1 1 
1 0 0 0 0 0 0 0 0 S 0 0 0 0 0 0 0 0 0 0 1 
1 0 1 1 1 1 1 1 1 1 1 1 1 1 1 1 1 0 1 0 1 
1 0 0 0 0 0 0 0 0 0 0 0 0 0 0 0 1 0 1 0 1 
1 1 1 1 1 1 1 1 1 1 1 1 1 1 1 1 1 0 1 0 1 
1 0 0 0 0 0 0 0 0 0 0 0 0 0 0 0 1 0 1 0 1 
1 0 1 1 1 1 1 1 1 0 1 0 1 1 1 1 1 0 1 1 1 
1 0 1 0 0 0 0 0 1 0 1 0 1 0 0 0 0 0 0 0 1 
1 0 1 1 1 1 1 0 1 0 1 0 1 0 1 0 1 1 1 0 1 
1 0 0 0 0 0 0 0 1 0 1 0 1 0 1 0 0 0 1 0 1 
1 1 1 1 1 1 1 0 1 0 1 1 1 0 1 1 1 1 1 0 1 
1 0 0 0 0 0 0 0 1 0 0 0 0 0 1 0 1 E 0 0 1 
1 1 1 1 1 1 1 1 1 1 1 1 1 1 1 0 1 0 1 1 1 
1 0 0 0 1 0 0 0 1 0 0 0 0 0 1 0 0 0 1 0 1 
1 0 1 0 1 0 1 0 1 0 1 0 1 1 1 0 1 1 1 0 1 
1 0 1 0 0 0 1 0 0 0 1 0 0 0 0 0 0 0 1 0 1 
1 1 1 1 1 1 1 1 1 1 1 1 1 1 1 1 1 0 1 0 1 
1 0 0 0 1 0 0 0 0 0 0 0 0 0 0 0 1 0 1 0 1 
1 0 1 0 1 0 1 1 1 1 1 1 1 0 1 1 1 0 1 0 1 
1 0 1 0 0 0 0 0 0 0 0 0 1 0 0 0 0 0 0 0 1 
1 1 1 1 1 1 1 1 1 1 1 1 1 1 1 1 1 1 1 1 1 
21 21
1 1 1 1 1 1 1 1 1 1 1 1 1 1 1 1 1 1 1 1 1 
1 0 0 0 0 0 1 0 0 S 0 0 0 0 0 0 0 0 1 0 1 
1 1 1 0 1 0 1 0 1 1 1 1 1 0 1 1 1 1 1 0 1 
1 0 0 0 1 0 0 0 0 0 1 0 0 0 1 0 0 0 0 0 1 
1 0 1 1 1 1 1 1 1 1 1 1 1 1 1 0 1 1 1 0 1 
1 0 0 0 0 0 0 0 0 0 0 0 0 0 0 0 0 0 1 0 1 
1 1 1 1 1 1 1 1 1 1 1 1 1 1 1 1 1 1 1 0 1 
1 0 0 0 1 0 0 0 0 0 0 0 0 0 0 0 1 0 0 0 1 
1 0 1 0 1 0 1 1 1 1 1 1 1 1 1 0 1 1 1 0 1 
1 0 1 0 0 0 1 0 0 0 0 0 0 0 1 0 1 0 0 0 1 
1 0 1 1 1 1 1 0 1 1 1 1 1 0 1 1 1 1 1 0 1 
1 0 0 0 0 0 0 0 0 0 0 0 1 0 0 0 0 E 0 0 1 
1 1 1 1 1 1 1 1 1 1 1 1 1 1 1 1 1 0 1 1 1 
1 0 0 0 0 0 1 0 0 0 0 0 0 0 0 0 1 0 0 0 1 
1 0 1 1 1 0 1 0 1 1 1 1 1 1 1 0 1 1 1 0 1 
1 0 0 0 1 0 1 0 0 0 1 0 0 0 1 0 0 0 0 0 1 
1 1 1 0 1 0 1 1 1 0 1 0 1 0 1 1 1 0 1 1 1 
1 0 1 0 1 0 0 0 1 0 1 0 1 0 0 0 1 0 1 0 1 
1 0 1 0 1 1 1 0 1 0 1 1 1 1 1 0 1 0 1 0 1 
1 0 0 0 0 0 1 0 0 0 0 0 0 0 0 0 1 0 0 0 1 
1 1 1 1 1 1 1 1 1 1 1 1 1 1 1 1 1 1 1 1 1 
143
9 9 1 
10 9 1 
11 9 1 
11 8 1 
11 7 1 
12 7 1 
13 7 1 
14 7 1 
15 7 1 
16 7 1 
17 7 1 
17 8 1 
17 9 1 
17 10 1 
17 11 1 
17 12 1 
17 13 1 
17 14 1 
17 15 1 
16 15 1 
15 15 1 
14 15 1 
13 15 1 
13 16 1 
13 17 1 
12 17 1 
11 17 1 
10 17 1 
9 17 1 
8 17 1 
7 17 1 
7 16 1 
7 15 1 
6 15 1 
5 15 1 
4 15 1 
3 15 1 
3 16 1 
3 17 1 
2 17 1 
1 17 1 
1 16 1 
1 15 1 
1 14 1 
1 13 1 
1 12 1 
1 11 1 
1 10 1 
1 9 1 
1 8 1 
1 7 1 
1 7 2 
1 7 3 
1 8 3 
1 9 3 
2 9 3 
3 9 3 
3 8 3 
3 7 3 
3 6 3 
3 5 3 
2 5 3 
1 5 3 
1 5 2 
1 5 1 
1 4 1 
1 3 1 
1 2 1 
1 1 1 
2 1 1 
3 1 1 
4 1 1 
5 1 1 
5 2 1 
5 3 1 
6 3 1 
7 3 1 
7 2 1 
7 1 1 
8 1 1 
9 1 1 
9 2 1 
9 3 1 
10 3 1 
11 3 1 
12 3 1 
13 3 1 
14 3 1 
15 3 1 
15 2 1 
15 1 1 
16 1 1 
17 1 1 
18 1 1 
19 1 1 
19 2 1 
19 3 1 
19 3 2 
19 3 3 
19 2 3 
19 1 3 
19 1 4 
19 1 5 
19 2 5 
19 3 5 
19 4 5 
19 5 5 
19 6 5 
19 7 5 
19 8 5 
19 9 5 
19 10 5 
19 11 5 
19 12 5 
19 13 5 
19 14 5 
19 15 5 
19 15 4 
19 15 3 
19 16 3 
19 17 3 
19 18 3 
19 19 3 
19 19 2 
19 19 1 
18 19 1 
17 19 1 
17 19 2 
17 19 3 
17 19 4 
17 19 5 
17 19 6 
17 19 7 
18 19 7 
19 19 7 
19 19 8 
19 19 9 
19 19 10 
19 19 11 
19 18 11 
19 17 11 
18 17 11 
17 17 11 
